NO ./textures/11.png
SO ./textures/12.png
WE ./textures/13.png   
EA ./textures/14.png

F 52,21,49
C 211,211,211

1111111111111111111111111
1000000000000000000000001
1111111111110000000000001
10010000000000000000000011111111
111111111011000001110000000000001
100000000011000001110111111111111
11110111111111010000000000001
11110111111111011101010010001
11000000110101011100000010001
10000000000000001100000010001
10000000000000001101010010001
11000001110101011111011110N0111
11110111 1110101 101111010001
11111111 1111111 111111111111
